1111111111111
1P001110001C1
1000C11000101
1000011000001
10C0011C00001
10000000C00E1
1111111111111
