1111111111111
1P000000C00E1
1111111111111
