1111111111111
1P000000000C1
1000000000001
1000000000001
1000000000011
10000000001E1
1111111111111
